Hi : High
Another Try : An Other Try
Leaf : Feel
Feel : Leaf
Tame : Mate
Cat : Tack
Trance : Transformation
Shun : Transformation
Form : Transformation
A : Transformation
Eye : Iris
Nighttime : Knight
Fine : Knife
Red : Bread
Much : Chum
Mask : Chasm
Tine : Night
Posh : Shop
Deicide : Decide
Lobe : Bowl
Kit : Tic
Irk Horn : Corner
Gel : Ledge
Though : Oath
Son : Sunrise
Rise : Sunrise
Rise : Horizon
Zen : Horizon
Sign : Sigh
Heartbreak : Brake
Airplane : Plain
Nightmare : Knight
Soar : Rose
Lie Lack : Lilac
Pacifist : Amethyst
Hairy : Cherry
Eye : Height
Ice : Eyesight
Height : Eyesight
Eye : Hi
Real Eyes : Realize
Pandemic : Pick
Flummoxed : Flood
Trinity : Tree
Chemistry : Key
Team : Meet
Teem : Meat
Eat : Tea
Might : Time
Safe : Face
Same : Mace
Funny : Enough
Came : Make
Dead End : Deadened
Sew : Sow
Dessert : Desert
Too : Two
To : Two
Ewe : You
Naught : Not
Knot : Not
Bear : Bare
Strays : Maze
Warner : Corner
Abyss : This
Knight : Write
Byte : Write
Maim : Same
Chair : Bear
Morgue : Cyborg
Bed : Dead
Walked : Blocked
Skies : Rise
Penned : Ascend
Trouble : Double
Violent : Silent
Bird : Word
Forbidden : Hidden
Scheme : Dream
History : Mystery
Loans : Bones
Repentance : Sentence
Wild : Child
Pistol : Crystal
Innovative : Creative
Fern : Return
Friend : Descend
Plump : Jump
Scrawl : Fall
Lays : Maze
Miss : Chemistry
Tree : Chemistry
Time Room : Rhyme Room